***************
***       0   ********************************
***                                   6      *
***********   **************************     *
          *   *                         *    *
    ********5***************            *  t *
    *                      *            ******
    *        t         1   *
    ************************